#####################
#                   #
# # # # # # # # # # #
#                   #
# # # # # # # # # # #
#                   #
# # # # # # # # # # #
#                   #
# # # # # # # # # # #
#                   #
# # # # # # # # # # #
#                   #
# # # # # # # # # # #
#                   #
# # # # # # # # # # #
#                   #
# # # # # # # # # # #
#                   #
# # # # # # # # # # #
#                   #
#####################
